 25
 96 2 186 336 265 5 102 103 7 189 104 274 106 15 14 18 201 116 351 199 23 280 203 205 119
 94 184 3 4 99 6 8 191 340 194 105 11 107 12 113 276 109 281 115 417 26 352 284 120 25
185 1 98 97 187 267 100 188 190 458 268 9 110 344 278 19 197 112 283 515 111 117 206 22 24
 93 95 263 266 339 459 101 270 271 507 192 10 193 467 108 202 516 17 415 412 348 118 20 124 27
334 183 262 259 338 404 341 401 346 547 273 349 13 198 347 343 196 511 354 350 355 21 208 123 29
 92 337 264 335 261 269 400 461 272 405 545 406 509 553 16 195 279 353 470 209 204 282 472 121 30
182 181 179 180 402 544 398 506 501 342 463 580 622 556 468 411 345 584 414 356 122 286 207 31 28
 90 333 176 177 332 399 505 403 460 601 503 512 513 408 275 200 114 514 469 418 552 211 416 126 32
 91 88 331 397 456 614 576 600 546 548 578 518 464 462 583 466 277 471 586 290 476 125 473 213 210
 89 258 257 178 453 260 396 407 457 504 603 577 617 554 550 0 410 551 358 520 285 517 359 127 33
 86 87 330 455 395 452 451 454 596 502 591 409 615 510 582 465 474 292 419 35 413 287 212 128 34
 85 175 256 329 450 394 572 543 549 573 598 599 581 605 618 555 611 357 420 360 291 288 294 129 36
 84 174 255 328 500 574 575 542 541 571 602 508 597 608 579 532 585 557 361 421 422 214 289 130 37
173 254 327 326 393 539 499 497 595 538 624 619 623 616 567 609 606 477 425 558 215 295 293 131 38
 83 172 253 325 449 392 540 570 566 612 613 529 530 621 604 588 475 521 522 423 362 133 216 217 39
 82 171 252 390 391 448 537 498 534 565 592 440 594 610 607 587 560 523 561 424 363 367 132 40 41
 81 169 170 389 388 495 496 569 494 535 536 492 533 562 563 527 433 484 478 524 364 365 218 296 42
 80 251 250 446 445 447 387 441 593 491 531 620 438 487 590 559 483 369 482 426 298 138 134 297 43
 79 168 323 248 324 443 386 444 381 490 436 564 489 308 486 307 589 479 519 368 429 366 46 135 219
 78 167 249 318 322 493 383 442 315 155 379 568 375 427 437 526 232 370 525 430 480 303 222 137 136
 77 166 247 319 385 317 380 314 378 439 313 312 485 434 146 58 372 373 144 301 428 304 221 220 44
 76 165 320 321 384 246 316 240 238 235 488 237 435 371 148 309 528 431 300 299 229 54 45 145 47
 75 164 245 244 243 242 241 239 382 236 311 60 61 310 374 233 481 432 228 305 226 48 302 139 49
 74 163 162 70 161 68 159 157 156 154 153 152 231 376 59 150 57 55 53 143 56 227 223 224 51
 73 72 71 160 69 67 66 158 64 65 63 377 62 306 234 151 230 149 147 52 225 140 142 50 141
